.,Y,Y,Y,Y,Y,.,.
.,Y,Y,Y,Y,.,.,.
.,Y,N,B,N,Y,.,.
.,R,.,.,R,.,.,.
.,.,R,R,R,.,.,.
.,.,.,.,.,.,.,.
