.,.,.,.,.,.,.,.
.,R,R,.,B,.,.,.
.,R,.,R,.,B,.,.
.,R,R,.,B,G,G,.
.,.,Y,.,.,B,.,.
Y,Y,Y,Y,B,.,.,.
